1111111111111
1001000000EC1
1C000000001P1
1000000000111
1111111111111