1111111111111
1E01000000011
1C00000000001
1P00000000001
1111111111111
