111111111111111111
10000000000C000001
100000C00000000001
1P000CEC0000000001
100000C00000000001
100000000C00000001
1000000C0000000001
100000000000000001
100000000000000001
111111111111111111
